0 0 0 0 0 0 0 0 0 0 0 0 0 0 0 0 0 0 0 0 0 0 0 0 0 0 0 0 0 0 0 0 0 0 0 0 0 0 0 0 0 0 0 0 0 0 0 0 0 0 0 0 0 0 0 0 0 0 0 0 0 0 0 0 0 0 0 0 0 0 0 0 0 0 0 0 0 0 0 0 0 0 0 0 0 0 0 0 0 0 0 0 0 0 0 0 0 0 0 0 
0 0 0 0 0 0 0 0 0 0 0 0 0 0 0 0 0 0 0 0 0 0 0 0 0 0 0 0 0 0 0 0 0 0 0 0 0 0 0 0 0 0 0 0 0 0 0 0 0 0 0 0 0 0 0 0 0 0 0 0 0 0 0 0 0 0 0 0 0 0 0 0 0 0 0 0 0 0 0 0 0 0 0 0 0 0 0 0 0 0 0 0 0 0 0 0 0 0 0 0 
0 0 0 0 0 0 0 0 0 0 0 0 0 0 0 0 0 0 0 0 0 0 0 0 0 0 0 0 0 0 0 0 0 0 0 0 0 0 0 0 0 0 0 0 0 0 0 0 0 0 0 0 0 0 0 0 0 0 0 0 0 0 0 0 0 0 0 0 0 0 0 0 0 0 0 0 0 0 0 0 0 0 0 0 0 0 0 0 0 0 0 0 0 0 0 0 0 0 0 0 
0 0 0 0 0 0 0 0 0 0 0 0 0 0 0 0 0 0 0 0 0 57 0 0 0 0 0 0 0 57 0 0 0 0 0 0 0 0 0 0 0 0 0 0 0 0 0 0 0 0 0 0 0 0 0 0 0 0 0 0 0 0 0 0 0 0 0 0 0 0 0 0 0 0 0 0 0 0 0 0 0 0 0 0 0 0 0 0 0 0 0 0 0 0 0 0 0 0 0 0 
0 0 0 0 0 0 0 0 0 0 0 0 0 0 0 0 0 55 0 0 0 0 0 0 0 0 0 0 0 0 0 0 0 0 0 0 0 0 0 57 0 0 0 0 0 0 0 0 0 0 0 0 0 0 0 0 57 0 0 0 0 0 0 0 0 0 0 55 0 0 0 0 0 0 56 0 0 0 0 0 0 0 0 0 0 0 0 0 0 0 0 0 0 0 0 0 0 0 0 0 
0 0 0 0 0 0 0 0 0 0 0 0 0 0 0 0 0 0 0 0 0 0 0 0 0 0 0 0 0 0 0 0 55 0 0 0 0 0 0 0 0 0 0 0 0 0 0 0 0 0 0 0 0 0 0 0 0 0 0 0 0 0 0 0 0 0 0 0 0 0 0 0 0 0 0 0 0 0 0 0 0 0 0 0 0 0 0 0 0 0 0 0 0 0 0 0 0 0 0 0 
0 0 0 0 0 0 0 0 0 0 0 0 0 0 0 0 0 0 0 0 0 0 0 0 0 55 0 0 0 0 0 0 0 0 0 0 0 56 0 0 0 0 0 0 0 0 0 0 57 0 0 0 0 0 0 0 0 0 0 56 0 0 0 0 0 0 0 0 0 0 0 0 0 0 0 0 0 0 0 0 0 0 0 0 0 0 0 0 0 0 0 0 0 0 0 0 0 0 0 0 
0 0 0 0 0 57 0 0 0 0 0 0 0 0 0 0 0 0 0 0 56 0 0 0 0 0 0 0 0 0 0 0 0 0 0 0 0 0 0 0 0 0 0 0 0 0 0 0 0 0 0 0 0 55 0 0 0 0 0 0 0 0 0 0 0 0 0 0 0 0 0 57 0 0 0 0 0 0 0 0 0 0 0 0 0 0 0 0 0 0 0 0 0 0 0 0 0 0 0 0 
0 0 0 0 0 0 0 0 0 0 57 0 0 0 0 0 0 0 0 0 0 0 0 0 0 0 0 0 58 59 59 59 59 59 59 59 59 59 59 59 60 0 0 0 55 0 0 0 0 0 0 0 0 0 0 0 0 0 51 246 49 49 49 49 49 49 49 49 49 52 0 0 0 0 0 0 0 0 56 0 0 55 0 0 0 0 0 0 0 0 0 0 0 0 0 0 0 0 0 0 
0 0 0 0 0 0 0 0 0 0 0 0 0 0 0 55 0 0 0 0 58 59 59 59 59 59 59 59 70 30 30 30 30 30 30 30 30 30 30 30 63 0 0 0 0 0 0 0 0 56 0 0 0 0 0 0 0 51 50 14 14 14 14 14 14 14 14 14 14 48 49 49 49 52 0 0 0 0 0 0 0 0 0 0 0 0 0 0 0 0 0 0 0 0 0 0 0 0 0 0 
0 0 0 0 0 0 0 0 0 0 0 0 0 0 0 0 0 0 58 59 70 30 30 30 30 30 30 30 30 30 30 30 30 30 30 30 816 816 816 816 69 59 60 0 0 0 57 0 0 0 0 0 0 51 246 246 246 50 14 14 14 14 14 14 14 14 14 14 14 14 14 14 14 48 49 49 52 0 0 0 0 0 57 0 0 0 0 0 0 0 0 0 0 0 0 0 0 0 0 0 
0 0 0 0 0 0 0 0 0 0 0 0 0 0 0 0 58 59 70 30 30 30 30 30 30 30 30 30 30 30 30 30 30 39 30 30 816 816 816 816 62 30 69 59 60 0 0 0 0 0 0 51 246 50 532 528 528 528 528 575 575 575 575 575 575 575 575 575 534 14 14 14 14 14 14 14 48 49 52 0 0 0 0 0 0 55 0 0 0 0 0 0 0 0 0 0 0 0 0 0 
0 0 0 0 0 0 0 0 0 0 0 0 56 0 0 58 70 30 30 30 30 30 30 30 30 30 30 30 39 30 30 30 30 30 30 118 119 120 62 30 30 30 30 30 63 0 0 0 0 51 246 50 14 14 546 589 589 589 589 589 589 589 589 589 589 589 589 589 548 563 14 14 14 14 14 14 14 14 48 49 49 49 52 0 0 0 0 0 0 0 0 57 0 0 0 0 0 0 0 0 
0 0 0 0 0 0 0 0 55 0 0 0 0 0 58 70 30 30 30 30 30 30 30 30 30 30 30 30 30 30 30 30 30 30 30 121 122 123 62 62 30 30 30 30 63 0 0 0 0 47 14 14 14 14 560 566 566 566 566 566 566 566 566 566 566 566 566 566 574 528 528 533 533 533 533 533 533 533 533 533 534 14 48 49 52 0 0 0 0 0 0 0 0 0 0 0 0 0 0 0 
0 0 0 0 0 0 0 0 0 0 0 0 0 58 70 71 72 72 73 30 30 30 39 30 30 30 30 30 30 816 816 816 816 30 30 121 122 123 62 62 41 30 30 30 63 0 0 55 0 47 14 14 14 14 560 14 14 14 14 14 14 14 14 14 14 14 14 14 588 547 547 547 547 547 547 547 547 547 547 547 548 563 14 14 48 52 0 0 0 0 0 0 0 0 0 0 0 0 0 0 
0 0 0 0 0 0 0 0 0 0 0 0 58 70 30 74 75 75 76 30 30 30 30 30 30 30 41 30 30 816 816 816 816 30 62 121 122 123 62 62 62 62 62 30 69 60 0 0 0 47 14 14 14 14 560 14 14 14 14 14 14 14 14 14 14 14 14 14 14 14 14 14 14 14 14 14 14 14 14 14 562 563 14 14 14 48 52 0 56 0 0 0 0 0 0 0 0 0 0 0 
0 0 0 0 0 0 0 0 0 0 0 0 61 30 30 74 75 75 76 30 30 30 30 30 30 30 30 30 30 30 30 118 119 120 62 121 122 123 62 62 62 62 30 30 30 63 0 0 0 53 44 14 14 14 560 14 14 14 14 14 14 14 14 14 14 14 14 14 14 14 14 14 14 14 14 14 14 14 14 14 562 563 14 14 14 14 48 52 0 0 0 0 0 0 0 0 0 0 0 0 
0 0 0 0 0 0 0 0 0 56 0 58 70 30 30 74 75 75 76 30 30 30 30 30 30 30 118 119 119 119 119 130 122 129 119 130 122 123 62 62 62 62 30 30 30 63 0 0 0 0 53 44 14 14 560 14 14 14 14 14 14 14 14 14 14 14 14 14 14 14 14 14 14 14 14 14 14 14 14 14 574 575 575 575 575 529 14 45 0 0 0 0 55 0 0 0 0 0 0 0 
0 0 0 0 0 57 0 0 0 0 0 61 30 30 30 77 78 78 79 30 30 40 30 30 30 30 121 122 122 122 122 122 122 122 122 122 122 123 62 62 62 30 30 30 30 69 60 0 0 57 0 53 44 14 574 528 528 528 528 528 528 534 14 14 14 14 14 14 14 14 14 14 14 14 14 14 14 14 14 14 588 547 547 547 547 548 563 45 0 0 0 0 0 0 0 0 0 0 0 0 
0 0 0 0 0 0 0 0 0 0 0 61 30 30 30 30 30 30 30 30 30 30 30 30 30 30 121 122 127 125 125 125 125 125 125 125 125 126 62 39 62 30 30 30 30 30 63 0 0 0 0 0 53 44 588 589 589 589 589 589 589 548 14 14 14 14 14 14 14 14 14 14 14 14 14 14 14 14 14 14 14 14 14 14 14 562 563 45 0 0 0 0 0 0 0 0 0 0 0 0 
0 0 0 0 0 0 0 0 0 0 0 61 30 30 30 30 30 30 30 30 30 30 30 30 30 30 121 122 123 30 30 62 62 62 62 62 62 62 62 62 30 30 30 30 30 30 63 0 0 0 0 0 0 53 44 566 566 566 566 566 566 560 14 14 14 14 14 14 14 14 14 14 14 14 14 14 14 14 14 14 14 14 14 14 14 562 563 45 0 0 57 0 0 56 0 0 0 0 0 0 
0 0 0 0 0 0 0 55 0 0 0 61 30 30 30 30 30 41 30 30 39 30 30 30 30 30 121 122 123 30 62 62 62 67 65 65 68 62 30 67 65 68 30 30 30 30 63 0 0 0 0 56 0 0 53 44 14 14 14 14 14 560 14 14 14 14 14 14 14 14 14 14 14 14 14 14 14 14 14 14 14 527 528 528 528 576 563 45 0 0 0 0 0 0 0 0 0 0 0 0 
0 0 0 0 0 0 0 0 0 0 0 64 68 30 30 30 30 816 816 816 816 30 30 30 30 30 121 122 123 30 62 39 62 63 0 0 64 65 65 66 0 64 68 30 30 30 69 60 0 55 0 0 0 0 0 47 14 14 14 14 14 560 14 14 14 14 14 14 14 14 14 14 14 14 14 14 14 14 14 14 14 546 584 584 584 585 586 45 0 0 0 0 0 0 0 0 0 0 0 0 
0 0 0 0 0 0 0 0 0 0 0 0 64 68 30 30 30 816 816 816 816 30 30 30 30 118 130 122 129 120 30 62 62 69 60 0 0 0 0 0 0 0 64 68 30 30 30 69 60 0 0 0 0 0 0 53 44 14 14 14 14 560 14 14 14 14 14 14 14 14 14 14 14 14 14 14 14 14 14 14 14 562 563 14 14 14 42 54 0 0 0 0 0 0 0 0 0 0 0 0 
0 0 0 0 0 0 0 0 57 0 0 0 0 61 62 62 62 62 62 118 119 120 30 62 118 130 122 122 122 129 120 62 62 62 69 59 59 60 0 0 0 0 0 64 68 30 30 30 69 60 0 0 0 0 0 0 47 14 14 14 14 569 575 575 575 575 575 575 575 575 575 529 14 14 14 14 14 14 14 14 14 562 563 14 14 14 45 0 0 0 55 0 0 0 0 0 0 0 0 0 
0 0 0 0 0 0 0 0 0 0 0 0 0 61 62 118 119 119 119 130 122 129 119 119 130 122 127 125 128 122 123 30 62 62 62 67 65 66 0 0 0 0 0 0 61 30 30 30 30 69 60 0 0 55 0 0 53 44 14 14 14 583 584 584 584 584 584 584 584 584 584 548 14 14 14 14 14 14 14 14 14 562 563 14 14 14 45 0 0 0 0 0 0 0 0 0 0 0 0 0 
0 0 0 0 0 0 0 0 0 0 56 1 1 61 62 121 122 122 122 122 122 122 122 122 122 122 123 30 121 122 123 30 62 40 62 63 0 0 0 0 0 0 58 59 70 30 30 39 30 30 69 60 0 0 0 0 0 53 44 14 14 597 598 598 598 598 598 598 598 598 598 560 14 14 14 14 14 14 14 14 14 562 563 14 14 14 45 0 0 0 0 0 0 0 0 0 0 0 0 0 
0 0 0 0 0 0 0 0 0 0 0 0 0 61 62 124 125 125 125 125 125 125 125 125 128 122 129 119 130 122 123 30 62 62 62 69 59 59 59 59 59 59 70 30 30 30 30 30 30 30 30 69 60 0 0 0 0 0 53 44 14 14 14 14 14 14 14 14 14 14 14 560 14 14 14 14 14 14 14 14 14 562 563 14 14 42 54 0 0 0 0 0 0 0 0 0 0 0 0 0 
0 0 0 0 0 0 0 0 0 0 0 0 0 61 62 62 62 62 62 62 62 62 62 30 124 128 122 122 122 127 126 62 62 62 62 62 62 62 30 30 30 30 30 30 816 816 816 816 816 30 30 30 63 0 0 0 0 0 0 53 43 44 14 14 14 14 14 14 14 14 14 560 14 14 14 14 14 14 14 14 14 562 563 14 14 45 0 0 57 0 0 0 0 57 0 0 0 0 0 0 
0 0 0 0 57 0 0 55 0 0 0 0 58 70 62 62 62 62 62 62 62 62 62 30 30 124 128 122 127 126 30 62 62 62 62 62 62 118 119 119 119 119 119 119 119 120 816 816 816 30 30 30 69 60 0 0 0 0 0 0 0 47 14 14 14 14 14 14 14 14 14 560 14 14 14 14 14 14 14 14 14 562 563 14 14 45 0 0 0 0 0 0 0 0 0 0 0 0 0 0 
0 0 0 0 0 0 0 0 0 0 0 58 70 62 62 62 62 62 62 62 62 816 816 30 62 62 121 122 123 62 62 62 62 39 62 62 62 121 122 122 122 122 122 122 122 129 119 119 120 30 30 30 30 63 0 0 55 0 0 0 0 53 43 44 14 14 14 14 14 14 14 574 575 575 14 14 14 575 570 570 570 576 563 14 42 54 0 0 0 0 55 0 0 0 0 0 0 0 0 0 
0 0 0 0 0 0 0 0 0 0 58 70 62 62 62 62 62 62 62 62 62 816 816 62 62 62 121 122 123 62 41 62 816 816 816 816 62 121 122 127 125 125 125 125 125 125 125 125 126 30 30 30 30 63 0 0 0 0 0 57 0 0 0 53 44 14 14 14 14 14 14 588 589 589 14 14 14 589 589 589 589 590 14 14 45 0 0 0 0 0 0 0 0 0 0 0 0 0 0 0 
0 0 0 0 0 0 0 0 0 58 70 62 62 62 62 39 62 62 62 62 62 816 816 62 62 62 121 122 123 62 62 62 816 816 816 816 62 121 122 123 30 30 30 30 30 30 30 30 30 30 30 35 33 279 0 0 0 0 0 0 0 0 0 0 53 43 44 14 14 14 14 14 565 565 14 14 14 565 565 565 565 14 14 14 45 0 0 0 0 0 0 0 0 0 0 0 0 0 0 0 
0 0 0 0 0 0 57 0 0 61 62 62 41 62 62 62 62 62 40 62 118 119 120 30 62 62 121 122 123 62 62 62 62 62 118 119 120 121 122 123 30 30 30 30 30 30 30 30 30 30 35 34 14 262 249 0 57 0 0 0 0 0 0 0 0 0 53 44 14 14 14 14 14 14 14 14 14 14 14 14 14 14 14 14 45 0 55 0 0 0 0 0 0 0 0 0 0 0 0 0 
0 0 0 0 0 0 0 0 0 61 62 62 62 62 62 62 62 62 118 119 130 122 129 119 119 119 130 122 129 119 119 119 119 119 130 122 129 130 122 123 30 30 30 30 40 30 30 30 35 33 34 14 14 14 242 0 0 0 0 0 0 0 0 0 0 0 0 47 14 14 14 14 14 14 14 14 14 14 14 14 14 14 14 42 54 0 0 0 0 0 0 0 0 0 0 0 0 0 0 0 
0 0 0 0 0 0 0 0 0 61 62 62 62 62 62 62 62 62 121 122 122 122 122 122 122 122 122 122 122 122 122 122 122 122 122 122 122 122 122 123 30 30 30 30 30 30 35 33 34 14 14 26 27 169 170 171 172 173 174 171 172 173 174 171 174 171 174 175 176 14 606 14 14 14 14 14 14 14 14 14 14 14 42 54 0 0 0 0 0 0 0 0 0 0 0 0 0 0 0 0 
0 0 0 0 55 0 0 0 0 61 62 62 62 62 30 30 30 30 121 122 127 125 125 125 125 125 125 125 125 125 125 125 125 125 125 125 125 125 125 126 30 30 30 30 30 35 34 14 14 14 26 38 30 177 178 179 180 181 182 179 180 181 182 179 180 181 182 184 185 14 14 14 14 14 14 14 14 14 14 14 14 14 45 0 0 0 0 0 0 0 0 0 0 0 0 0 0 0 0 0 
0 0 0 0 0 0 57 0 0 61 62 62 816 816 816 816 816 30 121 122 123 62 62 41 62 62 62 62 62 62 62 62 62 62 62 62 62 62 30 30 30 30 30 35 33 34 14 14 14 26 38 30 30 185 186 187 188 189 190 187 188 189 190 185 186 187 188 191 192 14 14 14 14 14 14 14 14 14 14 42 43 43 54 0 0 0 0 0 0 0 0 0 0 0 0 0 0 0 0 0 
0 0 0 0 0 0 0 0 0 61 62 62 816 816 816 816 816 62 121 122 123 62 62 62 62 62 62 62 62 62 62 62 62 62 62 62 30 41 30 30 30 35 33 34 14 14 14 14 14 29 30 35 33 193 194 195 196 197 198 195 196 197 198 195 196 197 198 199 200 14 14 14 14 14 14 14 14 14 42 54 0 0 0 0 0 0 0 0 0 55 0 0 0 0 0 0 0 0 0 0 
0 0 0 0 0 0 0 0 0 61 62 118 119 119 119 119 119 119 130 122 123 62 62 62 62 62 62 62 40 62 62 62 39 62 62 62 62 30 30 30 35 34 14 14 14 14 14 14 26 38 30 31 14 14 205 206 207 206 207 206 207 206 207 206 207 206 207 210 14 14 14 14 14 14 14 14 14 42 54 0 0 0 0 0 0 0 0 0 0 0 0 0 0 0 0 0 0 0 0 0 
0 0 0 0 0 0 0 0 0 61 62 124 125 125 125 125 125 125 128 122 123 62 62 62 39 62 62 62 62 62 62 62 62 62 62 30 30 30 35 33 34 14 14 14 14 14 14 26 38 30 35 34 14 14 48 52 0 0 0 0 55 0 0 0 0 0 0 53 43 44 14 14 14 14 14 42 43 54 0 57 0 0 0 0 57 0 0 0 0 0 0 0 0 0 0 0 0 0 0 0 
0 0 0 0 0 0 0 55 0 61 62 62 62 62 62 62 62 62 121 122 123 62 62 62 62 62 62 62 62 62 41 30 30 30 30 30 35 33 34 14 14 14 14 14 14 14 14 29 30 35 34 14 14 14 14 48 49 49 49 49 49 49 52 0 0 57 0 0 0 53 43 43 43 43 43 54 0 0 0 0 0 0 248 246 246 246 246 246 249 0 0 0 56 0 0 0 0 0 0 0 
0 0 0 0 0 0 0 0 0 61 62 40 62 62 62 40 62 62 124 125 126 62 62 62 62 62 62 62 62 62 30 30 35 33 33 33 34 14 14 14 14 14 14 14 14 14 26 38 30 31 14 14 14 14 14 14 14 14 14 14 14 14 48 49 49 52 0 0 0 0 0 0 0 0 0 0 0 0 0 0 248 246 247 14 14 14 14 14 242 0 0 0 0 0 0 0 0 0 0 0 
0 0 0 0 0 0 0 0 0 61 62 62 62 62 30 30 30 30 30 30 62 62 62 62 62 62 35 33 33 33 33 33 34 14 14 14 14 14 14 14 14 14 14 14 26 27 38 30 35 34 14 14 14 14 14 14 14 14 14 14 14 14 14 14 14 48 49 249 0 0 0 57 0 0 0 0 0 248 246 246 247 14 14 14 14 14 14 14 262 254 0 0 57 0 0 0 0 0 0 0 
0 0 0 57 0 0 0 0 0 278 33 33 33 33 33 33 33 36 30 30 41 35 33 33 33 33 34 14 14 14 14 14 14 14 14 14 14 14 14 14 14 14 14 26 38 30 30 35 34 14 14 14 14 14 14 14 14 14 14 14 14 14 14 14 14 14 14 242 0 0 0 0 0 248 246 246 246 247 14 14 14 14 14 14 14 14 14 14 14 262 254 0 0 0 0 0 0 0 0 0 
0 0 0 0 0 0 0 0 0 47 14 14 14 14 14 14 14 29 30 30 30 31 14 14 14 14 14 14 14 14 14 14 14 14 14 14 14 14 14 14 14 14 26 38 30 35 33 34 14 14 14 14 14 14 14 14 14 14 14 14 14 14 14 14 14 14 239 251 56 0 0 0 0 244 425 418 418 418 418 418 427 14 26 27 27 27 28 14 14 14 256 0 0 0 55 0 0 0 0 0 
0 0 0 0 0 0 0 0 0 47 14 14 14 14 14 14 14 29 30 30 30 31 14 14 14 14 14 14 14 14 14 14 14 14 14 14 14 14 14 14 14 26 38 30 35 34 14 14 14 14 14 14 14 14 14 14 14 14 14 14 14 14 14 14 14 14 242 0 0 0 0 0 0 244 416 14 14 14 14 14 420 14 29 39 30 41 31 14 14 14 256 0 0 0 0 0 0 0 0 0 
0 0 0 0 0 55 0 0 0 47 14 14 14 14 14 14 14 29 30 30 30 31 14 14 14 14 14 14 14 14 14 14 14 14 14 14 14 14 14 14 26 38 30 35 34 14 14 14 14 14 14 14 14 14 14 14 14 14 14 14 14 14 14 14 14 239 251 0 0 0 0 55 248 247 416 14 14 14 14 14 420 14 29 30 30 39 31 526 526 526 256 0 0 0 0 0 0 0 0 0 
0 0 0 0 0 0 0 0 0 47 14 14 14 14 14 14 14 29 30 30 30 31 14 14 14 14 14 14 14 14 14 14 14 14 14 14 14 14 26 27 38 30 35 34 14 14 14 14 14 14 14 14 14 14 14 14 14 14 14 14 14 14 14 14 14 242 0 0 0 57 0 248 247 14 416 14 14 14 14 14 420 14 32 36 30 35 34 526 526 526 256 0 0 0 0 0 57 0 0 0 
0 0 0 0 0 0 0 0 0 47 14 14 14 14 14 14 14 29 30 30 30 31 14 14 14 14 14 14 14 14 14 14 14 14 14 14 14 26 38 30 30 35 34 14 14 14 14 14 14 14 14 14 14 14 14 14 14 14 14 14 14 14 14 14 14 242 57 0 0 0 0 244 14 14 429 418 418 418 418 418 419 14 14 29 30 31 14 526 526 526 256 0 0 55 0 0 0 0 0 0 
0 0 0 0 0 0 0 0 0 47 14 14 14 14 14 14 14 29 30 30 30 31 14 14 14 14 14 14 14 14 14 14 14 14 14 14 26 38 30 35 33 34 14 14 14 14 14 14 14 14 14 14 14 14 14 14 14 14 14 14 14 14 14 14 14 242 55 0 0 0 0 244 14 14 14 14 14 14 14 14 14 14 14 29 30 31 14 526 526 526 262 254 0 0 0 0 0 0 0 0 
0 0 0 0 57 0 0 56 0 47 14 14 14 14 14 14 14 29 30 30 30 37 28 14 14 14 14 14 14 14 14 14 14 14 14 26 38 30 35 34 14 14 14 14 14 14 14 14 14 14 14 14 14 14 14 14 14 14 14 14 14 14 14 14 14 242 0 0 0 0 248 247 526 526 526 526 14 14 135 135 135 135 14 29 30 31 14 14 14 14 14 256 0 0 0 0 56 0 0 0 
0 0 0 0 0 0 0 0 0 47 14 14 14 14 14 14 14 32 36 30 30 30 37 27 28 14 14 14 14 14 14 14 14 26 27 38 30 35 34 14 14 14 14 137 144 144 144 144 144 144 144 138 14 14 14 14 14 14 14 14 14 14 14 14 239 251 0 0 0 248 247 14 526 526 526 526 14 14 14 14 14 14 14 29 30 31 135 14 14 14 14 256 0 0 0 0 0 0 0 0 
0 0 0 0 0 0 0 0 0 47 14 14 14 14 14 14 14 14 29 30 30 30 30 30 37 27 28 14 14 14 14 14 26 38 30 30 35 34 14 14 14 14 14 272 153 153 153 153 153 153 153 270 14 14 14 14 14 14 14 14 14 14 14 239 251 56 0 0 248 247 14 14 14 14 26 27 27 27 27 27 27 27 27 38 41 31 14 14 14 14 14 256 0 0 0 0 0 0 0 0 
0 0 0 0 0 0 0 0 0 47 14 14 14 14 14 14 14 14 32 36 30 30 30 30 30 30 37 27 28 14 14 26 38 30 35 33 34 14 14 14 14 14 14 273 160 160 160 610 610 160 160 271 14 14 14 14 14 14 14 14 14 14 239 251 0 0 0 248 247 14 14 14 135 135 29 30 41 30 30 39 30 30 30 30 30 31 14 14 14 14 14 256 0 0 0 0 0 0 0 0 
0 0 0 0 0 0 0 0 0 47 14 14 14 14 14 14 14 14 14 29 30 30 30 30 30 30 30 30 37 27 27 38 30 30 31 14 14 14 14 14 14 14 14 281 167 167 167 167 167 167 167 280 14 14 14 14 14 14 14 14 14 14 242 0 248 249 55 244 14 14 14 14 14 14 32 33 33 33 33 33 33 33 33 33 33 34 14 14 14 14 14 256 0 0 55 0 0 0 0 0 
0 0 0 0 0 56 0 0 0 47 14 14 14 14 14 14 14 14 14 32 33 36 30 30 30 30 30 30 30 30 30 30 30 30 31 14 14 14 14 14 14 14 14 136 14 14 26 27 27 28 14 143 144 144 144 144 144 144 144 144 144 144 261 0 0 0 0 259 144 144 144 144 144 144 139 140 141 144 144 144 144 144 144 144 144 144 144 144 144 144 144 261 0 0 0 0 0 57 0 0 
0 0 0 0 0 0 0 0 0 47 14 14 19 17 20 14 14 14 14 14 14 32 33 33 36 30 30 30 30 30 30 30 30 30 37 27 27 28 14 14 14 14 14 136 14 14 29 30 30 31 14 152 153 153 153 153 153 153 153 153 153 153 265 0 0 0 0 264 153 153 153 153 153 153 148 149 150 153 153 153 153 153 153 153 153 153 153 153 153 153 153 265 0 0 0 0 0 0 0 0 
0 0 0 0 0 0 0 0 0 47 14 14 15 14 16 20 14 14 14 14 14 14 14 14 32 33 33 36 30 30 30 30 30 30 30 30 30 31 14 14 137 144 144 145 14 14 29 30 30 31 14 159 160 160 160 160 160 160 160 160 160 160 267 0 0 0 0 266 160 160 160 160 160 160 155 156 157 160 160 610 610 610 160 160 160 160 160 160 160 160 160 267 0 57 0 0 0 0 0 0 
0 0 0 0 0 0 0 0 0 47 14 14 21 11 12 16 20 14 14 14 14 14 14 14 14 14 14 32 33 33 33 33 36 30 30 30 30 31 14 14 272 153 153 154 14 14 29 30 30 31 14 166 167 167 167 167 167 167 167 167 167 167 242 0 0 0 0 244 167 167 167 167 167 167 162 163 163 167 167 14 14 14 167 167 167 167 167 167 167 167 167 283 0 0 0 0 0 0 0 0 
0 0 0 0 0 0 55 0 0 47 14 14 14 14 15 14 16 17 17 17 17 20 14 14 14 14 14 14 14 14 14 14 32 36 30 30 30 31 14 14 273 160 160 161 14 14 29 30 30 31 14 14 14 14 14 14 14 14 14 14 14 14 242 56 250 251 0 244 14 14 14 14 14 14 14 14 14 14 14 14 14 14 14 14 526 526 526 526 526 526 14 45 0 0 0 56 0 0 0 0 
0 0 0 0 0 0 0 0 0 47 14 14 14 14 21 11 12 14 14 14 10 22 14 14 14 14 14 14 14 14 14 14 14 29 30 30 30 31 14 14 281 167 167 168 14 14 29 30 30 31 14 14 14 14 14 14 14 14 14 14 14 14 242 0 0 0 0 244 14 14 14 14 14 14 14 14 14 14 14 14 26 27 27 27 27 27 28 14 14 14 14 45 0 0 0 0 0 0 0 0 
0 0 0 0 0 0 0 0 0 47 14 14 14 14 14 14 21 11 11 11 22 14 14 14 14 14 14 14 14 14 14 14 14 29 30 30 30 31 14 14 136 14 14 14 14 14 29 30 30 37 27 27 27 27 27 27 27 27 27 27 27 169 170 171 172 173 174 175 176 27 27 27 27 27 27 28 14 14 14 14 29 30 39 30 40 30 31 14 14 14 14 45 0 0 0 0 0 0 0 0 
0 0 0 0 0 57 0 0 0 47 14 14 14 14 14 14 14 14 14 14 14 14 14 14 14 14 14 14 14 14 14 14 14 32 33 33 33 34 14 14 136 14 14 14 14 14 29 30 30 30 30 30 30 30 30 30 30 30 30 30 30 177 178 179 180 181 182 183 184 30 30 30 30 39 30 37 28 14 14 14 29 30 35 33 33 33 34 14 14 14 14 45 0 0 57 0 0 0 0 0 
0 0 0 0 0 0 0 0 0 259 144 144 144 144 144 144 144 144 144 138 14 14 14 14 14 14 14 14 14 14 268 144 144 139 140 140 140 141 144 144 145 14 14 14 14 14 29 30 30 30 30 30 30 30 30 30 30 30 30 30 30 185 186 187 188 189 190 191 192 30 39 30 30 30 30 40 37 28 14 14 29 30 31 14 14 14 14 14 14 14 14 45 0 0 0 0 0 55 0 0 
0 0 0 0 0 0 0 0 0 264 153 153 153 153 153 153 153 153 153 270 14 14 14 14 14 14 14 14 14 14 272 153 153 148 149 149 149 150 153 153 154 14 14 14 14 14 29 30 35 33 33 33 33 33 33 33 33 33 33 33 33 193 194 195 196 197 198 199 200 33 33 33 33 33 36 30 30 37 27 27 38 30 37 28 14 14 14 14 14 14 14 45 0 0 0 0 0 0 0 0 
0 0 0 0 55 0 0 0 0 266 160 160 160 160 160 160 160 160 160 271 14 14 14 14 14 14 14 14 14 14 273 160 160 155 156 156 156 157 160 160 161 14 14 14 14 14 29 30 31 14 14 14 14 14 14 14 14 14 14 14 14 14 205 206 207 208 209 210 14 14 14 14 14 14 32 36 30 30 30 30 39 41 30 31 14 14 14 14 14 14 14 45 0 0 0 0 0 0 0 0 
0 0 0 0 0 0 0 0 0 282 167 167 167 167 167 167 167 167 167 280 14 14 14 14 14 14 14 14 14 14 281 167 167 162 163 163 163 164 167 167 168 14 14 14 14 14 29 30 31 14 19 17 17 17 17 20 14 14 14 14 14 42 54 0 0 0 0 47 14 14 14 14 14 14 14 32 36 39 30 30 30 30 30 31 14 14 14 14 14 14 14 45 0 0 0 0 0 0 57 0 
0 0 0 0 0 0 57 0 0 47 14 14 14 14 14 14 14 14 14 134 14 14 14 14 14 14 14 14 14 14 136 14 26 27 27 27 27 27 27 27 27 27 27 27 27 27 38 30 31 14 15 14 14 14 10 22 14 14 14 14 42 54 0 0 0 0 51 50 14 14 14 14 14 14 14 14 29 30 30 30 30 30 40 31 14 14 14 26 27 27 27 274 0 0 55 0 0 0 0 0 
0 0 0 0 0 0 0 0 0 47 14 14 14 14 14 14 14 14 14 134 14 14 14 14 14 14 14 14 14 14 136 14 29 30 30 30 30 30 30 30 30 30 30 30 30 30 30 30 31 14 15 14 14 10 22 14 14 14 14 42 54 0 0 0 0 51 50 26 27 27 27 27 27 27 27 27 38 30 30 41 30 30 30 31 14 14 14 29 30 30 41 63 0 0 0 0 0 0 0 0 
0 0 0 0 0 0 0 0 0 47 14 14 14 14 14 14 14 14 14 134 14 14 14 14 14 14 14 14 14 14 136 14 32 33 33 33 33 33 36 30 35 33 33 33 33 33 33 33 34 14 15 14 14 13 14 14 14 42 43 54 0 0 0 0 0 47 14 29 30 30 30 30 30 30 30 30 30 39 30 30 30 30 39 31 526 526 526 32 33 36 30 63 0 0 0 0 0 0 0 0 
0 0 0 0 0 0 0 0 0 53 44 14 14 14 14 14 14 14 14 143 144 144 144 144 144 144 144 144 144 144 145 14 14 14 14 14 14 14 29 30 31 14 14 14 14 14 14 14 14 14 21 11 11 22 14 42 43 54 0 0 0 0 0 0 51 50 14 29 30 35 33 33 33 33 33 33 36 30 40 30 30 30 30 31 526 526 526 14 14 29 30 63 0 0 0 0 56 0 0 0 
0 0 0 0 0 0 0 0 0 0 47 14 14 14 14 14 14 14 14 152 153 153 153 153 153 153 153 153 153 153 154 14 14 14 14 14 14 14 29 30 31 14 14 14 14 14 14 14 14 14 14 14 14 14 42 54 0 57 0 0 0 0 0 51 50 14 14 29 30 31 14 14 14 14 14 14 32 33 33 36 30 35 33 34 526 526 526 14 14 29 39 63 0 0 0 0 0 0 0 0 
0 0 0 0 0 0 0 56 0 0 47 14 14 14 14 14 14 14 14 159 160 160 160 160 160 160 160 160 160 160 161 14 14 14 14 14 14 14 29 30 31 14 14 14 14 14 14 14 14 14 14 14 42 43 54 0 0 0 0 0 55 0 51 50 14 14 14 29 30 31 14 526 526 526 526 526 14 14 14 29 30 31 14 14 14 14 14 14 14 29 30 63 0 0 0 0 0 0 0 0 
0 0 0 0 0 57 0 0 0 0 47 14 14 14 14 14 14 14 14 166 167 167 167 167 167 167 167 167 167 167 168 14 14 14 14 14 14 14 29 30 31 14 14 14 14 14 14 14 14 42 43 43 54 0 0 0 0 0 0 0 51 49 50 14 14 14 14 29 30 31 14 526 526 526 526 526 14 14 14 29 30 31 14 14 14 14 14 14 14 29 40 63 0 0 57 0 0 0 0 0 
0 0 0 0 0 0 0 0 0 0 47 14 14 14 14 14 14 14 14 14 14 14 14 14 14 14 14 14 14 14 14 14 14 14 14 14 14 14 29 30 31 14 14 14 14 14 14 14 42 54 0 0 0 0 0 0 0 0 0 51 50 14 14 14 14 14 26 38 30 31 14 14 14 14 14 14 14 14 14 29 40 37 27 27 27 27 27 27 27 38 30 63 0 0 0 0 0 0 0 0 
0 0 0 0 0 0 0 0 0 0 47 14 14 14 14 14 14 14 14 14 14 14 14 14 14 14 14 14 14 14 14 14 14 14 14 14 14 14 29 30 31 14 14 14 14 14 42 43 54 0 0 0 0 0 0 0 51 49 49 50 14 14 14 14 14 26 38 30 35 34 26 27 27 27 27 27 27 27 28 29 41 30 30 30 30 39 30 30 40 30 30 63 0 0 0 0 0 0 0 0 
0 0 0 0 0 0 0 0 0 0 53 44 14 14 14 14 14 14 14 14 14 14 14 14 14 14 14 14 14 14 14 14 14 14 14 14 14 14 29 30 31 14 14 14 14 14 45 0 0 0 0 57 0 51 49 49 50 14 526 526 526 526 14 14 26 38 30 35 34 14 29 71 72 72 72 72 72 73 31 29 30 35 33 33 33 33 33 33 36 30 39 63 0 0 0 55 0 0 0 0 
0 0 0 0 0 0 0 55 0 0 0 47 14 14 14 14 14 14 14 14 14 14 14 14 14 14 14 14 14 14 14 14 14 14 14 14 14 14 29 30 31 14 14 14 42 43 54 0 0 0 0 51 49 50 14 14 14 14 14 14 14 14 14 26 38 40 35 34 14 14 29 74 75 75 75 75 75 76 31 29 30 31 14 14 14 14 14 14 32 36 41 63 0 0 0 0 0 0 0 0 
0 0 0 0 0 0 0 0 0 0 0 53 44 14 14 14 14 14 14 14 14 14 14 14 14 14 14 14 14 14 14 14 14 14 14 14 14 26 38 30 31 14 14 14 45 0 0 0 0 0 51 50 14 14 14 14 14 14 14 26 27 27 27 38 30 35 34 14 14 14 29 77 78 78 78 78 78 79 31 29 30 31 14 14 14 14 14 14 14 32 36 63 0 56 0 0 0 0 0 0 
0 0 0 0 0 0 0 0 0 0 0 0 47 14 14 14 14 14 14 14 14 14 14 14 14 14 14 14 14 14 14 14 14 14 26 27 27 38 30 35 34 14 14 42 54 0 0 0 0 51 50 14 14 14 14 14 14 14 14 32 33 33 36 30 30 31 14 14 14 14 32 33 33 33 33 33 33 33 34 29 40 31 14 14 14 14 14 14 14 14 32 279 0 0 0 0 0 57 0 0 
0 0 0 0 0 0 0 0 0 0 0 0 53 44 14 14 14 14 14 14 26 27 27 27 27 28 14 14 14 14 14 14 26 27 38 30 30 30 35 34 14 14 14 45 0 57 0 0 51 50 14 14 14 14 14 14 14 14 14 14 14 14 29 30 30 37 27 27 27 27 27 27 27 27 27 27 27 27 27 38 30 31 14 14 14 14 14 14 14 14 14 45 0 0 0 0 0 0 0 0 
0 0 0 0 57 0 0 0 0 0 0 0 0 53 44 14 14 14 14 26 38 62 62 62 62 37 27 27 28 14 14 26 38 30 30 35 33 33 34 14 14 14 42 54 0 0 0 0 47 14 14 526 526 526 526 526 14 14 14 14 14 26 38 35 33 33 33 33 33 33 33 33 33 33 33 33 33 33 33 36 30 31 14 526 526 526 526 526 14 14 42 54 0 0 0 0 0 0 0 0 
0 0 0 0 0 0 0 0 56 0 0 0 0 0 53 44 14 26 27 38 62 62 62 62 62 62 62 62 37 27 27 38 30 30 35 34 14 14 14 14 14 14 45 0 0 0 0 0 47 14 14 526 526 526 526 526 14 14 14 14 26 38 35 34 14 14 14 14 14 14 14 14 14 14 14 14 14 14 14 29 30 31 14 526 526 526 526 526 14 42 54 0 0 0 55 0 0 0 0 0 
0 0 0 0 0 0 0 0 0 0 0 0 56 0 0 275 27 38 62 62 62 62 62 62 62 62 62 62 62 62 30 30 30 30 37 27 27 27 27 27 27 27 274 0 0 0 0 55 53 44 14 14 14 14 14 14 14 14 14 14 29 30 31 14 14 14 14 14 14 14 14 14 14 14 14 14 14 14 14 29 30 31 14 14 14 14 14 14 42 54 0 0 0 0 0 0 0 0 0 0 
0 0 0 0 0 0 0 0 0 0 0 0 0 0 0 64 68 30 62 62 62 62 62 62 62 62 62 62 62 62 62 62 62 62 62 62 62 62 62 62 62 62 63 0 0 0 0 0 0 53 44 26 27 27 27 27 27 27 27 27 38 30 31 14 14 14 14 14 526 526 526 526 526 14 14 14 14 14 14 29 41 31 14 14 14 14 14 42 54 0 0 0 0 0 0 0 0 0 0 0 
0 0 0 0 0 0 0 0 0 0 0 0 0 0 57 0 64 68 62 62 62 62 30 30 62 62 62 62 62 62 62 62 62 62 62 62 62 62 62 62 62 67 66 0 0 0 57 0 0 0 47 32 33 33 33 33 33 33 33 33 36 30 31 14 14 14 14 14 526 526 526 526 526 14 14 14 14 14 26 38 30 31 14 14 14 42 43 54 0 0 0 0 0 0 0 0 0 0 0 0 
0 0 0 0 0 0 0 0 0 0 0 0 0 0 0 0 0 64 65 68 62 62 30 30 30 62 62 62 62 62 62 62 62 67 65 65 65 65 65 65 65 66 0 55 0 0 0 0 0 0 53 44 14 14 14 14 14 14 14 14 32 36 37 27 27 27 28 14 14 14 14 14 14 26 27 27 27 27 38 35 33 34 14 14 42 54 0 0 0 0 0 55 0 0 0 0 0 0 0 0 
0 0 0 0 0 0 0 0 0 0 0 0 0 0 0 0 0 0 0 64 68 30 30 30 30 30 62 62 62 62 67 65 65 66 0 0 56 0 0 0 0 0 0 0 0 0 0 0 0 0 0 53 43 43 44 14 14 14 14 14 14 32 33 33 33 36 37 27 27 27 27 27 27 38 35 33 33 33 33 34 42 43 43 43 54 0 0 0 56 0 0 0 0 0 0 0 0 0 0 0 
0 0 0 0 0 0 0 0 0 0 57 0 0 0 0 0 0 0 0 0 64 30 30 30 30 67 65 65 65 65 66 0 0 0 0 0 0 0 0 0 0 0 0 0 0 0 0 0 0 0 0 0 0 0 53 43 43 43 43 43 43 43 43 43 44 32 33 33 33 33 33 33 33 33 34 42 43 43 43 43 54 0 0 0 0 0 0 0 0 0 0 0 0 0 57 0 0 0 0 0 
0 0 0 0 0 0 0 0 0 0 0 0 0 0 0 0 0 0 55 0 0 64 65 65 65 66 0 0 0 0 0 0 0 0 56 0 0 0 0 0 0 0 0 0 0 0 0 0 0 0 0 0 0 0 0 0 0 0 0 0 0 0 0 0 53 43 43 43 43 43 43 43 43 43 43 54 0 0 0 0 0 0 0 0 0 0 0 0 0 0 0 0 0 0 0 0 0 0 0 0 
0 0 0 0 0 0 0 0 0 0 0 0 0 0 0 0 0 0 0 0 0 0 0 0 0 0 0 0 0 0 56 0 0 0 0 0 0 0 57 0 0 0 56 0 0 0 0 0 0 0 57 0 0 0 0 0 0 0 55 0 0 0 0 0 0 0 0 0 0 0 0 0 0 0 0 0 0 0 0 0 0 0 0 57 0 0 0 55 0 0 0 0 0 0 0 0 0 0 0 0 
0 0 0 0 0 0 0 0 0 0 0 0 0 0 0 0 0 0 0 0 0 0 55 0 0 56 0 0 0 0 0 0 0 0 0 0 0 0 0 0 0 0 0 0 0 0 0 0 0 0 0 0 0 0 0 0 0 0 0 0 0 0 0 0 56 0 0 0 0 0 0 0 0 0 0 0 0 0 0 0 0 0 0 0 0 0 0 0 0 0 0 0 0 0 0 0 0 0 0 0 
0 0 0 0 0 0 0 0 0 0 0 0 0 0 0 0 0 0 0 0 0 0 0 0 0 0 0 0 0 0 0 0 0 56 0 0 0 0 0 0 0 0 0 0 0 0 0 0 55 0 0 0 0 0 0 0 0 0 0 0 57 0 0 0 0 0 0 0 0 0 0 0 0 0 0 0 0 0 0 0 0 0 0 0 0 0 0 0 0 0 0 0 0 0 0 0 0 0 0 0 
0 0 0 0 0 0 0 0 0 0 0 0 0 0 0 0 0 0 0 0 0 0 0 0 0 0 0 0 0 0 0 0 0 0 0 0 0 0 0 0 0 0 0 0 0 0 0 0 0 0 0 0 0 0 0 0 0 0 0 0 0 0 0 0 0 0 0 0 0 57 0 0 0 0 0 55 0 0 0 0 0 0 56 0 0 0 0 0 0 0 0 0 0 0 0 57 0 0 0 0 
0 0 0 0 0 0 0 0 0 0 0 0 0 0 0 0 0 0 0 0 0 0 0 0 0 0 0 0 0 0 0 0 0 0 0 0 0 0 0 0 0 0 0 0 0 0 0 0 0 0 0 0 0 0 56 0 0 0 0 0 0 0 0 0 0 0 0 0 0 0 0 0 0 0 0 0 0 0 0 0 0 0 0 0 0 0 0 0 0 0 0 0 0 0 0 0 0 0 0 0 
0 0 0 0 0 0 0 0 0 0 0 0 0 0 0 0 0 0 0 0 0 0 0 0 0 0 0 0 0 0 0 0 0 0 0 0 0 0 0 0 0 0 0 0 0 0 0 0 0 0 0 0 0 0 0 0 0 0 0 0 0 0 0 0 0 0 0 0 0 0 0 0 0 0 0 0 0 0 0 0 0 0 0 0 0 0 0 0 0 0 0 0 0 0 0 0 0 0 0 0 
0 0 0 0 0 0 0 0 0 0 0 0 0 0 0 0 0 0 0 0 0 0 0 0 0 0 0 0 0 0 0 0 0 0 0 0 0 0 0 0 0 0 0 0 0 0 0 0 0 0 0 0 0 0 0 0 0 0 0 0 0 0 0 0 0 0 0 0 0 0 0 0 0 0 0 0 0 0 0 0 0 0 0 0 0 0 0 0 0 0 0 0 0 0 0 0 0 0 0 0 
0 0 0 0 0 0 0 0 0 0 0 0 0 0 0 0 0 0 0 0 0 0 0 0 0 0 0 0 0 0 0 0 0 0 0 0 0 0 0 0 0 0 0 0 0 0 0 0 0 0 0 0 0 0 0 0 0 0 0 0 0 0 0 0 0 0 0 0 0 0 0 0 0 0 0 0 0 0 0 0 0 0 0 0 0 0 0 0 0 0 0 0 0 0 0 0 0 0 0 0 
0 0 0 0 0 0 0 0 0 0 0 0 0 0 0 0 0 0 0 0 0 0 0 0 0 0 0 0 0 0 0 0 0 0 0 0 0 0 0 0 0 0 0 0 0 0 0 0 0 0 0 0 0 0 0 0 0 0 0 0 0 0 0 0 0 0 0 0 0 0 0 0 0 0 0 0 0 0 0 0 0 0 0 0 0 0 0 0 0 0 0 0 0 0 0 0 0 0 0 0 
